||||   ||||
|.     | ?|
|      |  |
|  |   |  |
|  | ..|  |
|  | . |  |
|  |.. |  |
|  |      |
|! |     .|
||||   ||||