|||||||||||
|!  .|.  ?|
|    |   o|
|         |
|  .   .  |
|  |   |  |
|  | o |  |
|..|...|..|
|..|...|..|
|||||||||||