|||||||||||
|.       .|
|         |
|         |
|   |!|   |
|   |||   |
| .. o    |
| .. o    |
| .. o   ?|
|||||||||||