|||||.|||||
|         |
|         |
|         |
....|!|....
|   |||   |
|   o     |
|   o  ?  |
|   o     |
|||||.|||||