||||||    |
|!   | .. |
|    |....|
|    ||||||
|        ?|
|       o |
|    |    |
| oo |    |
| .. |    |
||||||    |