||||||      |||||
|..         |  ?|
|.          |   |
|           |   |
|    |   ...|   |
|    |      |   |
|    |...   |   |
|    |      |   |
|    |   ...|   |
|    |      |   |
|    |...   |   |
|    |          |
|    |         .|
|!   |        ..|
||||||      |||||