|||||||||||||||||      
|!  o .|.|.    ?|
|      | |    o |
|      | |      |
|      | |      |
|      | |      |
|               |
|    .     .    |
|    |     |    |
|    |  o  |    |
|... | ... | ...|
| ...|.....|... |
|... | ... | ...|
| ...|.....|... |
|||||||||||||||||