|||||||||||||||||      
|...............|
|               |
|               |
|    |||!|||    |
|    |||||||    |
|    |||||||    |
|    |||||||    |
|    |||||||    |
| ...   o       |
| ...   o ?     |
| ...   o .     |
|||||||||||||||||