||||||||.||||||||      
|               |
|               |
|               |
.....|||!|||.....
|    |||||||    |
|    |||||||    |
|    |||||||    |
|    |||||||    |
| .. o          |
| .. o    ?     |
|    o          |
||||||||.||||||||