|||||||||   o   |      
|       |  ...  |
|   !   | ..... |
|       |.......|
|       |||||||||
|               |
|       o   ?   |
|               |
|   o   |       |
|       |       |
|  ...  |       |
|       |       |
|||||||||       |