|  .    . ..  ...     ..   |
| ||||||| |||||||| ||||||| |
|o|||||||.|||||||| |||||||o|
| . .  ||..  ||    ||      |
|||||| || || ||.|| || ||||||
|||||| || || || || || ||||||
    ||   .||.|| || .  ||    
||| || || ||  ..|| || || |||
||| || || |||||||| || || |||
||| || || |||||||| ||.|| |||
|||  . ||          ||.   |||
||| ||||| |||--||| |||||.|||
|||.||||| |      | ||||| |||
| .   !|| |      | ||?     |
| |||| || |      | || |||| |
| |||| || |||||||| ||.|||| |
|  .||                ||   |
||| ||.|| |||||||| ||.|| |||
||| || || |||||||| ||.|| |||
|||    ||    ||    ||    |||
||| |||||||| ||.|||||||| |||
||| |||||||| || |||||||| |||
   .   ||        . ||.      
||| ||.|| |||||||| ||.|| |||
|||.|| || |||||||| || || |||
|   ||    . .||       ||.  |
| ||||||| || ||!|| ||||||| |
