|  .   .    ..     .       |
| ||||.||.||||||||.||.|||| |
|o|||| || ||||||||.|| ||||o|
|   || ||..  || . .||.||   |
||| ||.|| ||.|| ||.|| || |||
||| || ||.|| ||.|| ||.||.|||
||| ||.||.|| || || || || |||
  ..   .. ||    ||   ...    
| ||||||| |||||||| |||||||.|
| ||||||| |||||||| |||||||.|
| ||.                  .||.|
| || |||| |||--||| |||| ||.|
| || |||| |      | ||||.|| |
| .  .   !|      |?  ..    |
| |||| || |      | || |||| |
| ||||.|| |||||||| || |||| |
|.||. .||          ||.  ||.|
| ||.||||||| || ||||||| ||.|
| ||.||||||| || |||||||.|| |
 .... .|| . .||. . ||     . 
| |||| || ||||||||.|| |||| |
| |||| || ||||||||.|| ||||.|
|        .  .    .         |
| || ||||.|||||||| ||||.|| |
|o|| |||| |||||||| ||||.||.|
| ||..  ..   ||       . || |
|o|||||.||||.|| |||| |||||.|
