|    . ..  .          ..   |
| |||| || |||||||| || |||| |
|o|||| ||.|||||||| || ||||o|
|   || ||  ..||.  .|| ||.  |
|||.|| || ||.|| || || || |||
|||.|| ||.|| || ||.|| || |||
||| || || || || || ||.|| |||
    .     || !..||. ..    . 
| ||||||| |||||||| ||||||| |
|.||||||| |||||||| ||||||| |
| ||.                   ||.|
| || |||| |||--||| |||| || |
|.|| |||| |      | ||||.|| |
|    .    |      |   .    .|
| ||||.|| |      | ||.|||| |
|.|||| || |||||||| ||.||||.|
| ||   ||    ?     ||   || |
| || ||||||| || |||||||.||.|
| ||.||||||| || ||||||| || |
  .    ||    ||    ||.  .   
|.|||| || |||||||| || |||| |
| |||| || |||||||| ||.||||.|
| .      .. .      .  .    |
| || ||||.|||||||| |||| || |
|o|| ||||.|||||||| ||||.|| |
| ||       . ||      . .||.|
|o|||||.||||.|| |||| ||||| |
