|      .  ..   . .  ..  . .|
| ||||||| |||||||| ||||||| |
|o||||||| |||||||| |||||||o|
|   ||       ||      .||   |
||| || || ||.|| || || || |||
||| || || ||.|| || ||.||.|||
|||.||?|| || || || || || |||
|||    || ||    || ||.. .|||
||| ||||| |||||||| ||||| |||
|||.||||| |||||||| |||||.|||
     . ||          ||       
||| || || |||--||| || || |||
||| ||.|| |      | || || |||
|. .||    |      |    ||.  |
| |||| || |      | || |||| |
|.|||| || |||||||| || ||||.|
| ..  .||          ||      |
| || ||||||| || |||||||.|| |
| ||.||||||| || |||||||.||.|
| ||   . .   ||    ..   || |
| ||||||| |||||||| ||||||| |
| ||||||| |||||||| ||||||| |
|..                .       |
|.||.||||.|||||||| ||||.|| |
| || |||| |||||||| |||| || |
| ||   || || !  || || ..|| |
| |||| ||.|| ||.||.|| |||| |
