|.  .    . .             . |
|.|||||||.|||||||| ||||||| |
|o|||||||.|||||||| |||||||o|
|  .|| . ..  ||  .    || ..|
||| || || ||.|| || || || |||
||| || || || || || || || |||
|||.|| || || || || || || |||
|||.   || ||  . || || .. |||
||| ||||| |||||||| ||||| |||
||| ||||| |||||||| ||||| |||
       ||          ||..     
||| || || |||--||| || || |||
|||.||.|| |      | || ||.|||
|. .||.   |      |    ||   |
| |||| || |      | || |||| |
| |||| || |||||||| ||.|||| |
|. ... ||          ||  .  .|
| || ||||||| || ||||||| || |
| || ||||||| || ||||||| || |
| ||       . ||     ..  || |
| |||||||.|||||||| ||||||| |
| ||||||| |||||||| ||||||| |
|      . .. .!     .     . |
| || |||| ||||||||.|||| || |
| ||.|||| |||||||| |||| ||.|
|.|| . || || ?. || || . || |
| ||||.|| || ||.|| || ||||.|
