|    . .   .   .        .  |
| |||| || |||||||| || |||| |
| ||||.|| |||||||| || ||||.|
|o|||| ||    ||  ..||.||||o|
|      || || || || ||    ..|
| || ||||.|| ||.|| ||||.||.|
| ||.|||| || || || |||| || |
| ||      ||.. .|| .    || |
| |||| || |||||||| ||.||||.|
| |||| || |||||||| ||.|||| |
|     .||          ||  ... |
||||.|||| |||--||| |||| ||||
|||| |||| |      | |||| ||||
||||      |      |      ||||
|||| |||| |      | |||| ||||
|||| |||| |||||||| |||| ||||
|||| ||              || ||||
|||| || |||| || |||| || ||||
||||.||.|||| || |||| ||.||||
        ||  .||...||.       
||||.||.|| |||||| ||.|| ||||
|||| ||.|| ||||||.|| || ||||
|. . || .   .  .     ||    |
| || ||||||| ||.||||||| || |
|!|| ||||||| || ||||||| ||.|
|o||.        ||     .   ||.|
|?|||| || |||||||| || |||| |
