|   .     ||.  .||        .|
| ||||||| || || ||.||||||| |
|o|||||||.|| || || |||||||o|
|   ||    ...|| .     ||   |
||| || ||.|||||||| || ||.|||
||| ||.|| ||||||||.|| || |||
||| || ||    .  . .|| || |||
|||..  || |||||||| ||   .|||
||| ||||| |||||||| ||||| |||
||| ||||| |||||||| |||||.|||
|. .          !            |
| ||||||| |||--||| ||||||| |
| ||||||| |      | ||||||| |
| ..||.   |      |   .||. .|
||| ||.|| |      | || || |||
|||.|| || |||||||| || ||.|||
       ||          ||   .   
||| |||||||| || |||||||| |||
||| |||||||| || |||||||| |||
| ...  ||.   || .  ||      |
| ||||.|| ||||||||.|| |||| |
| ||||.||.|||||||| || |||| |
|  .               .  .    |
| ||||||| |||||||| ||||||| |
| ||||||| |||||||| ||||||| |
| ||..       ||   . . . ||?|
| || |||| || ||.|| ||||.||o|
