|         ||   .||  .   . .|
|.|||||||.|| || ||.|||||||.|
|o||||||| ||.|| ||.|||||||o|
|  .||...   .||       ||   |
||| || || |||||||| || || |||
||| || ||.|||||||| || || |||
||| ||.||    ..    || ||.|||
|||..  || |||||||| ||  . |||
||| ||||| |||||||| |||||.|||
|||.||||| |||||||| |||||.|||
|            !             |
| ||||||| |||--||| |||||||.|
| ||||||| |      | ||||||| |
|.. ||    |      |    ||   |
|||.|| || |      | || || |||
||| ||.|| |||||||| || || |||
       ||          ||. .    
||| |||||||| || |||||||| |||
|||.|||||||| || |||||||| |||
|.  .. ||    || .  ||      |
| |||| || |||||||| || ||||.|
| ||||.|| ||||||||.|| |||| |
| . .       . ?  . . .     |
| ||||||| |||||||| |||||||.|
|.|||||||.|||||||| ||||||| |
| ||.  .     ||    .    ||.|
| || |||| || ||.|| |||| ||o|
