|   ..  .    || . .    .   |
| |||| |||||.||.|||||.|||| |
|o|||| ||||| || ||||| ||||o|
|    .   .|| || || .       |
|||.||||| || .  || ||||| |||
||| ||||| ||.|| || ||||| |||
|||.   || || || || ||    |||
||| ||.||    || .  || ||.|||
||| || || |||||||| || || |||
|||.|| || |||||||| || || |||
||| ||                || |||
||| ||||| |||--||| ||||| |||
    ||||| |      | |||||.  ?
|||.||    |      |    ||.|||
|||.|| || |      | || || |||
||| ||.|| |||||||| ||.|| |||
|||.||!||          || || |||
||| ||.||||| || ||||| || |||
||| || ||||| || ||||| || |||
|       ..   ||  .   ..    |
| |||| ||.|||||||| || |||| |
|.|||| || |||||||| || |||| |
|.||.  ||      . . ||. .||.|
| || |||| || || || ||||.||.|
|.||.|||| || || ||.||||.||.|
|..       || || ||.. .    .|
|o|||| |||||.|| ||||| |||| |
