|     .     .||.           |
| |||| ||||| || ||||| ||||.|
|o|||| ||||| || |||||.||||o|
|   .  ...||.|| || .   ..  |
||| ||||| || .. || |||||.|||
||| ||||| || ||.||.||||| |||
|||  . ||.||.|| ||.||  . |||
||| || ||    || .. || || |||
||| || || |||||||| ||.||.|||
||| || || |||||||| || || |||
|||.||                || |||
||| ||||| |||--||| |||||.|||
    ||||| |      | |||||    
||| ||    |      |    ||.|||
||| || || |      | || || |||
||| || || |||||||| ||.||.|||
||| ||!||          || || |||
|||.||.||||| || ||||| || |||
||| || ||||| || ||||| || |||
| .      .   ||  .  .    .?|
| |||| || ||||||||.|| |||| |
| |||| ||.|||||||| || |||| |
| ||   ||. ..    ..||   ||.|
|.|| |||| || ||.|| |||| || |
| || |||| ||.||.|| ||||.|| |
|       ..|| || ||      . .|
|o|||| ||||| || ||||| ||||.|
