|     . ..   || .          |
| |||| ||||| || ||||| |||| |
|o|||| |||||.|| ||||| ||||o|
| .       || ||.||    . . .|
||| ||||| || .  || ||||| |||
|||.||||| || ||.|| ||||| |||
|||  . || || || ||.||.   |||
|||.|| ||    || .  || || |||
|||.|| || |||||||| || ||.|||
||| || || |||||||| || ||.|||
||| ||                || |||
|||.||||| |||--||| |||||.|||
   .||||| |      | |||||  ? 
||| ||.   |      |   !|| |||
||| ||.|| |      | || || |||
||| ||.|| |||||||| || || |||
|||.|| ||          || ||.|||
|||.||.||||| || ||||| || |||
||| || ||||| || ||||| || |||
|       . . .||    . . .   |
|.||||.|| |||||||| || ||||.|
| |||| ||.||||||||.|| |||| |
| ||  .||        . || . || |
|.||.|||| || || || |||| || |
| || |||| || ||.|| ||||.||.|
|     .   || || ||       . |
|o|||| |||||.|| ||||| ||||.|
