|  .      ||   .|| .   . ..|
| |||| || || ||.|| || ||||?|
|o|||| || ||.|| || || ||||o|
|!     ||.|| || || || ..  .|
||| ||||| ...||  ..||||| |||
||| |||||.|||||||| ||||| |||
   .   || |||||||| ||  .    
|||.||.||  . ..    || || |||
||| ||.|| |||||||| || || |||
||| ||.|| |||||||| || || |||
|.  ||                ||   |
| |||| || |||--||| ||.|||| |
| |||| || |      | || |||| |
|  .   || |      | ||  .  .|
||| ||||| |      | |||||.|||
||| ||||| |||||||| |||||.|||
|||                      |||
|||.|||||||| || ||||||||.|||
||| |||||||| || |||||||| |||
   .||    .  ||       ||    
|||.|| || ||||||||.|| || |||
||| ||.||.|||||||| || || |||
|||  . || .      ..||    |||
||| || ||||| || |||||.|| |||
|||.|| ||||| ||.|||||.|| |||
|.. || ||..  ||    ||.|| . |
| |||| || ||||||||.|| |||| |
