|..........................|
|.|||||||.||||||||.|||||||.|
|o|||||||.||||||||.|||||||o|
|......||....||....||......|
||||||.||.||.||.||.||.||||||
||||||.||.||.||.||.||.||||||
    ||....||.||.||....||    
||| ||.|| ||....|| ||.|| |||
||| ||.|| |||||||| ||.|| |||
|||!||.|| |||||||| ||.|| |||
|||....||          ||....|||
|||.||||| |||--||| |||||.|||
|||.||||| |      | |||||.|||
|......|| |      | ||......|
|.||||.|| |      | ||.||||.|
|.||||.|| |||||||| ||.||||.|
|...||.              .||...|
|||.||.|| |||||||| ||.||.|||
|||.||.|| |||||||| ||.||.|||
|||....||....||?...||....|||
|||.||||||||.||.||||||||.|||
|||.||||||||.||.||||||||.|||
   ....||....  ....||....   
|||.||.||.||||||||.||.||.|||
|||.||.||.||||||||.||.||.|||
|...||.......||.......||...|
|.|||||||.||.||.||.|||||||.|
