|......||..........||......|
|.||||.||.||||||||.||.||||.|
|o||||.||.||||||||.||.||||o|
|o||||.||.||....||.||.||||.|
|......||.||.||.||.||......|
|||.|||||.||.||.||.|||||.|||
|||.|||||.||.||.||.|||||.|||
   ..........||..........   
|||.||||| |||||||| |||||.|||
|||.||||| |||||||| |||||.|||
|||....||          ||....|||
|||.||.|| |||--||| ||.||.|||
|||.||.|| |      | ||.||.|||
|||!||.   |      |   .||?|||
|||.||||| |      | |||||.|||
|||.||||| |||||||| |||||.|||
|||.                    .|||
|||.|||||||| || ||||||||.|||
|||.|||||||| || ||||||||.|||
|||.||.......||.......||.|||
|||.||.||.||||||||.||.||.|||
|||.||.||.||||||||.||.||.|||
   ....||....  ....||....   
|||.||.|||||.||.|||||.||.|||
|||.||.|||||.||.|||||.||.|||
|...||.......||.......||...|
|o|||||||.||||||||.|||||||.|
