|.........||....||.........|
|.|||||||.||.||.||.|||||||.|
|o|||||||.||.||.||.|||||||o|
|...||.......||.......||...|
|||.||.||.||||||||.||.||.|||
|||.||.||.||||||||.||.||.|||
|||.||.||..........||.||.|||
|||....|| |||||||| ||....|||
|||.||||| |||||||| |||||.|||
|||.||||| |||||||| |||||.|||
|...          !         ...|
|.||||||| |||--||| |||||||.|
|.||||||| |      | |||||||.|
|...||.   |      |   .||...|
|||.||.|| |      | ||.||.|||
|||.||.|| |||||||| ||.||.|||
   ....||          ||....   
|||.|||||||| || ||||||||.|||
|||.|||||||| || ||||||||.|||
|......||....||....||......|
|.||||.||.||||||||.||.||||.|
|.||||.||.||||||||.||.||||.|
|............  ............|
|.|||||||.||||||||.|||||||.|
|.|||||||.||||||||.|||||||.|
|.||.........||.........||?|
|.||.||||.||.||.||.||||.||o|
