|............||............|
|.||||.|||||.||.|||||.||||.|
|o||||.|||||.||.|||||.||||o|
|.........||.||.||.........|
|||.|||||.||....||.|||||.|||
|||.|||||.||.||.||.|||||.|||
|||....||.||.||.||.||....|||
|||.||.||....||....||.||.|||
|||.||.|| |||||||| ||.||.|||
|||.||.|| |||||||| ||.||.|||
|||.||.              .||.|||
|||.||||| |||--||| |||||.|||
   .||||| |      | |||||.  ?
|||.||.   |      |   .||.|||
|||.||.|| |      | ||.||.|||
|||.||.|| |||||||| ||.||.|||
|||.||!||          ||.||.|||
|||.||.||||| || |||||.||.|||
|||.||.||||| || |||||.||.|||
|............||............|
|.||||.||.||||||||.||.||||.|
|.||||.||.||||||||.||.||||.|
|.||...||....  ....||...||.|
|.||.||||.||.||.||.||||.||.|
|.||.||||.||.||.||.||||.||.|
|.........||.||.||.........|
|o||||.|||||.||.|||||.||||.|
