|   . !   .. ..      .  .  |
| ||||.||.|||||||| || ||||.|
|o|||| || |||||||| || ||||o|
| . || || .. ||    || ||   |
||| || || ||.|| ||.|| ||.|||
||| ||.|| ||.|| ||.|| || |||
||| ||.||.|| ||.|| || ||.|||
          ||    ||...   ..  
|.||||||| |||||||| ||||||| |
|.||||||| |||||||| ||||||| |
| ||                    ||.|
| || |||| |||--||| ||||.|| |
| || |||| |      | |||| || |
|     .   |  ?   |   . .  .|
| |||| || |      | || |||| |
| |||| || |||||||| || |||| |
| ||.  ||          ||.. ||.|
|.|| ||||||| || |||||||.||.|
| ||.||||||| || ||||||| ||.|
  . .  ||. . ||    || .     
|.|||| || ||||||||.||.||||.|
| ||||.|| ||||||||.|| |||| |
|       .        ...      .|
| || |||| |||||||| |||| ||.|
|o|| |||| |||||||| |||| || |
| || . . .  .||   .     || |
|o||||| |||| || |||| |||||.|
