||||||||||||||||||||||||||||
|..   !    . .      .      |
| |||| || ||||||||.||.|||| |
|o||||.|| |||||||| || ||||o|
|.  || ||    ||. . || || . |
||| ||.|| ||.|| || ||.||.|||
||| || ||.|| || || || || |||
||| || ||.|| ||.|| || || |||
    .    .|| .. || .      . 
|.||||||| |||||||| |||||||.|
| ||||||| |||||||| ||||||| |
| ||                    || |
| || |||| |||--||| |||| || |
| || |||| |      | |||| || |
|.        |  ?   |   .    .|
| |||| || |      | ||.|||| |
|.|||| || |||||||| || ||||.|
|.||   ||          ||   || |
|.||.||||||| || ||||||| || |
|.||.||||||| || ||||||| || |
   . . || . .|| . .||     . 
| |||| ||.||||||||.|| |||| |
| |||| || |||||||| ||.|||| |
|           .    .  .  . . |
| || |||| |||||||| ||||.||.|
|o|| |||| ||||||||.|||| || |
| || . ....  ||..     . || |
|o||||| ||||.|| ||||.||||| |
