||||||||||||||||||||||||||||
|    ...     . .        .. |
| ||||||| |||||||| ||||||| |
|o||||||| ||||||||.|||||||o|
|..    ||   .|| .  ||..   .|
||||||.||.||.|| ||.|| ||||||
|||||| || ||.|| || ||.||||||
    ||    || || ||... ||    
||| || || ||.  .|| || || |||
||| || || |||||||| || || |||
||| ||.|| |||||||| || || |||
|||    ||          ||   .|||
||| ||||| |||--||| ||||| |||
|||.||||| |      | ||||| |||
|      || |  ?   | ||      |
| ||||.|| |      | ||.|||| |
| |||| || |||||||| ||.|||| |
|.  ||.               ||   |
||| || || |||||||| ||.|| |||
||| ||.|| |||||||| || ||.|||
|||.   ||.  .||    ||    |||
|||.||||||||.|| ||||||||.|||
||| |||||||| || |||||||| |||
      .||          ||.      
||| || || ||||||||.|| ||.|||
||| || || |||||||| || || |||
|...||  .    ||  .    || . |
| ||||||| || ||!|| ||||||| |
