||||||||||||||||||||||||||||
|       .  .  . .. . .    .|
| |||||||.|||||||| ||||||| |
|o||||||| |||||||| |||||||o|
|.   . ||   .||  ..||. .   |
|||||| || || || || || ||||||
||||||.|| || || || || ||||||
    || .  ||.|| ||    ||    
||| || || ||    || || || |||
||| || || |||||||| || || |||
||| ||.|| |||||||| || || |||
||| .. ||          ||  . |||
||| ||||| |||--||| ||||| |||
||| ||||| |      | |||||.|||
|.. . .|| |  ?   | ||. .   |
| |||| || |      | ||.|||| |
|.||||.|| |||||||| || |||| |
|.  ||.               ||   |
|||.|| || |||||||| || ||.|||
||| || || |||||||| || || |||
|||    ||   .||    || .. |||
||| |||||||| || ||||||||.|||
||| ||||||||.|| ||||||||.|||
   .  .||...   ..  ||   .   
|||.|| || |||||||| || || |||
||| || || ||||||||.|| || |||
|.  ||    .  ||      .||   |
| ||||||| || ||!|| ||||||| |
