| .  .   .   .             |
|.||||||| |||||||| ||||||| |
|o||||||| ||||||||.|||||||o|
|      ||..  ||    ||.     |
|||||| || || || || ||.||||||
||||||.|| || || || || ||||||
    ||    || || ||    ||    
||| ||.|| ||    || ||.|| |||
||| || || |||||||| || || |||
||| || || |||||||| ||.|| |||
|||.   ||          ||.   |||
||| ||||| |||--||| |||||.|||
||| ||||| |      | ||||| |||
|.  .  || |  ?   | ||  .   |
| |||| || |      | || ||||.|
| |||| || |||||||| || |||| |
| ..||               .|| . |
||| || || |||||||| || ||.|||
||| || || |||||||| || || |||
|||  . || .  ||  . ||    |||
||| |||||||| || |||||||| |||
|||.|||||||| || |||||||| |||
       || .    . ..|| .     
||| ||.|| |||||||| ||.|| |||
||| || || |||||||| ||.||.|||
|  .||   .  .||.      ||   |
|.||||||| || ||!|| |||||||.|
