| .. . .     .  .  .   .   |
|.|||||||.|||||||| ||||||| |
|o|||||||.|||||||| |||||||o|
|. .  .||    ||.   ||.  . .|
|||||| ||.|| || || || ||||||
|||||| ||.|| || || || ||||||
    ||    || || ||  . ||    
||| || || ||   .|| || || |||
||| || || |||||||| || || |||
|||!|| || |||||||| || || |||
|||.   ||          ||    |||
||| ||||| |||--||| ||||| |||
|||.||||| |      | ||||| |||
|      || |      | ||  . ..|
|.|||| || |      | ||.||||.|
| |||| || |||||||| ||.||||.|
|   ||                ||.  |
|||.|| || |||||||| || || |||
|||.||.|| |||||||| ||.||.|||
||| .  ||   .||?   ||.   |||
||| ||||||||.||.|||||||| |||
|||.|||||||| || |||||||| |||
       ||.       ..||.      
||| || ||.|||||||| ||.|| |||
|||.|| || |||||||| ||.|| |||
|   || .   . ||    . .||   |
| ||||||| || ||.|| ||||||| |
