|         .   .  . ..     .|
| ||||||| |||||||| ||||||| |
|o|||||||.|||||||| |||||||o|
|    . || .. || .. ||    . |
|||||| || || ||.|| || ||||||
||||||.|| || || ||.|| ||||||
    ||    || || ||  . ||    
||| ||.|| ||    || || || |||
||| || || |||||||| ||.|| |||
||| || || |||||||| || || |||
|||. . ||    ?     || .  |||
|||.||||| |||--||| ||||| |||
|||.||||| |      | ||||| |||
|  .   || |      | ||    . |
| |||| || |      | || |||| |
|.|||| || |||||||| ||.|||| |
| . ||.               ||. .|
||| || || |||||||| || || |||
||| || || |||||||| ||.|| |||
|||    ||  ..||.   ||    |||
||| |||||||| || |||||||| |||
||| ||||||||.|| ||||||||.|||
     ..||...       ||.  .   
||| ||.|| |||||||| || || |||
||| || || |||||||| || || |||
|   ||....  .|| .     ||   |
| |||||||.|| ||!|| |||||||.|
