|    .! . . ..  .    .    .|
| ||||.|| |||||||| || |||| |
|o|||| || ||||||||.|| ||||o|
|  .|| ||    || .  || ||   |
||| ||.||.|| || || || || |||
|||.|| || ||.|| || || ||.|||
||| || ||.|| ||.||.|| ||.|||
 ..  ..   ||   .||   .  . . 
|.||||||| |||||||| ||||||| |
|.||||||| |||||||| ||||||| |
| ||                    ||.|
| || |||| |||--||| |||| || |
| || |||| |      | |||| || |
|. .      |      |   .     |
| |||| || |      | || |||| |
| ||||.|| |||||||| || |||| |
| ||   ||          ||.  || |
| || ||||||| || ||||||| || |
| ||.||||||| || ||||||| || |
  ..  .||   .||  ..||  .. . 
| ||||.|| |||||||| || |||| |
|.||||.||.|||||||| || ||||.|
|..    .    .?   .   .  . .|
|.|| |||| |||||||| |||| ||.|
|o|| |||| ||||||||.|||| ||.|
| ||.. ..    ||  .      || |
|o|||||.|||| ||.||||.|||||.|
