|.    .|| .       .||  .   |
|.|||| ||.|||||||| ||.|||| |
|o|||| || |||||||| ||.||||o|
|o||||.|| ||    || || |||| |
|      || ||.|| || ||    . |
||| ||||| || || || |||||.|||
|||.|||||.|| || ||.||||| |||
         .   ||        .    
||| ||||| |||||||| ||||| |||
|||.||||| |||||||| ||||| |||
|||   .||          ||    |||
||| || || |||--||| ||.||.|||
||| || || |      | || || |||
||| ||    |   ?  |   .||.|||
|||.||||| |      | ||||| |||
||| ||||| |||||||| ||||| |||
|||                     .|||
||| |||||||| || |||||||| |||
|||.|||||||| || |||||||| |||
||| ||.. .  .||.      || |||
||| || || |||||||| ||.|| |||
||| || ||.|||||||| || || |||
   . . ||       .  ||       
||| || ||||| ||.||||| || |||
||| ||.||||| || |||||.|| |||
| ..||     . || ..!   ||   |
|o|||||||.||||||||.||||||| |
