| .  ..||     .   .||      |
| |||| || ||||||||.|| |||| |
|o|||| ||.|||||||| ||.||||o|
|o||||.|| ||    || || |||| |
|  .   || || || || ||. .   |
||| |||||.||.|| ||.|||||.|||
|||.||||| || || || |||||.|||
             ||. .   ...    
||| ||||| |||||||| ||||| |||
||| ||||| |||||||| ||||| |||
|||.   ||          ||   .|||
||| ||.|| |||--||| || || |||
|||.||.|| |      | || || |||
||| ||    |   ?  |    ||.|||
||| ||||| |      | ||||| |||
||| ||||| |||||||| |||||.|||
|||                      |||
||| |||||||| || |||||||| |||
||| |||||||| || ||||||||.|||
||| ||..    .||.      || |||
||| || || ||||||||.|| ||.|||
|||.|| || |||||||| || || |||
    .  ||.       ..||....   
|||.||.||||| || |||||.||.|||
||| || |||||.|| ||||| || |||
|.. || . .  .|| ..!   ||   |
|o||||||| |||||||| |||||||.|
