||||||||||||||||||||||||||||
|  . . ||.         ||.    .|
|.||||.|| |||||||| ||.||||.|
|o|||| || |||||||| ||.||||o|
|o||||.|| ||    ||.||.|||| |
|   .  ||.|| ||.|| || . .  |
|||.||||| || || ||.|||||.|||
||| ||||| ||.|| || |||||.|||
          . .||     .       
||| ||||| |||||||| ||||| |||
||| ||||| |||||||| ||||| |||
|||. . ||          ||    |||
||| || || |||--||| || || |||
||| || || |      | || ||.|||
||| ||.   |   ?  |   .|| |||
||| ||||| |      | ||||| |||
|||.||||| |||||||| ||||| |||
|||                     .|||
|||.|||||||| || |||||||| |||
||| |||||||| || |||||||| |||
|||.||.      ||   .   || |||
||| ||.||.||||||||.|| ||.|||
||| || || |||||||| ||.|| |||
       ||         .||   .   
|||.|| ||||| || ||||| || |||
||| ||.|||||.|| ||||| || |||
|   || .     ||   !   || ..|
|o|||||||.||||||||.||||||| |
