|  . . ||      ....||      |
| |||| || |||||||| || ||||.|
|o||||.||.||||||||.|| ||||o|
|o|||| ||.||   .|| || ||||?|
|....  ||.||.|| || ||.. . .|
|||.||||| || || || |||||.|||
|||.||||| ||.|| ||.||||| |||
      ..   ..||   . .  ..   
||| ||||| |||||||| ||||| |||
||| ||||| |||||||| ||||| |||
|||.   ||          ||    |||
|||.||.|| |||--||| || ||.|||
||| ||.|| |      | || || |||
||| ||    |      |    || |||
|||.||||| |      | ||||| |||
||| ||||| |||||||| |||||.|||
|||           !          |||
|||.|||||||| || |||||||| |||
||| |||||||| || |||||||| |||
||| ||     ..||  .... || |||
||| ||.|| |||||||| || || |||
||| || ||.|||||||| || || |||
       ||..     . .||   .   
||| || ||||| || ||||| ||.|||
||| || ||||| ||.||||| ||.|||
| . ||     ..|| .. . .||  .|
|o||||||| |||||||| |||||||.|
