|   .. ||     .    || .. ..|
| ||||.|| |||||||| || |||| |
|o||||.|| |||||||| || ||||o|
|o|||| ||.||  ?.|| || |||| |
|  .   ||.|| ||.|| || .    |
||| ||||| ||.|| || ||||| |||
|||.||||| ||.||.|| |||||.|||
   . .  .   .||    ..       
||| ||||| |||||||| |||||.|||
||| ||||| |||||||| ||||| |||
|||    ||          ||    |||
||| ||.|| |||--||| ||.|| |||
|||.||.|| |      | || || |||
||| ||    |      |    || |||
||| ||||| |      | ||||| |||
||| ||||| |||||||| |||||.|||
|||                      |||
|||.|||||||| || |||||||| |||
||| |||||||| || ||||||||.|||
||| || . . . ||.  ... || |||
|||.||.|| |||||||| || || |||
||| || || |||||||| || || |||
     . ||    !     ||.      
||| ||.|||||.||.||||| || |||
||| ||.||||| || ||||| || |||
|   || .     ||.      ||  .|
|o||||||| |||||||| ||||||| |
