| .    ||...  .    ||.     |
|.|||| || |||||||| || |||| |
|o|||| || |||||||| || ||||o|
|o||||.||.||. . || ||.|||| |
|     .|| || ||.|| ||.     |
||| ||||| || || ||.||||| |||
||| |||||.||.|| || |||||.|||
    .   .  . ||             
|||.||||| |||||||| ||||| |||
||| ||||| |||||||| ||||| |||
|||    ||          ||    |||
||| || || |||--||| || || |||
||| || || |      | || || |||
|||!||.   |      |    ||?|||
|||.||||| |      | ||||| |||
||| ||||| |||||||| ||||| |||
|||                      |||
||| |||||||| || ||||||||.|||
||| |||||||| || ||||||||.|||
||| ||     ..||.   .  ||.|||
||| || ||.|||||||| || || |||
|||.|| || |||||||| || || |||
    .  ||      .   ||       
|||.|| ||||| ||.|||||.||.|||
||| ||.|||||.|| |||||.|| |||
|  .||...    ||       ||  .|
|o||||||| |||||||| |||||||.|
