|  .  .           .        |
|.||||||| |||||||| ||||||| |
|o||||||| ||||||||.|||||||o|
|   || .. . .||   .  .|| . |
|||.|| || || || || || || |||
||| ||.|| || ||.|| ||.||.|||
|||.|| || || ||.|| ||.||.|||
|||. ..|| ||. . || ||    |||
||| ||||| |||||||| ||||| |||
||| ||||| |||||||| |||||.|||
     ..||          ||.      
||| || || |||--||| || || |||
||| || || |      | || || |||
|  .||    |   ?  |   .||.. |
| |||| || |      | || |||| |
| ||||.|| |||||||| ||.|||| |
|  .  .||          ||     .|
| || ||||||| || |||||||.|| |
| || ||||||| || ||||||| || |
| ||    . . .||    .    || |
| |||||||.|||||||| ||||||| |
| ||||||| |||||||| ||||||| |
|  .      ..   .         . |
|.|| |||| ||||||||.|||| || |
| || |||| ||||||||.|||| || |
|.||  .||.|| !  ||.||.  || |
| |||| || || || || || |||| |
