|    ..   ..  ..     .     |
|.||||||| |||||||| ||||||| |
|o||||||| |||||||| |||||||o|
|   ||       ||. .    ||   |
|||.||.|| || ||.|| ||.||.|||
||| || || || || || || || |||
||| || || || || || ||.|| |||
|||  . || ||.   || ||. . |||
|||.||||| |||||||| ||||| |||
||| ||||| |||||||| ||||| |||
    .  ||          ||       
||| || || |||--||| || || |||
||| ||.|| |      | || || |||
|.  ||    |   ?  |    ||   |
|.||||.|| |      | ||.|||| |
| |||| || |||||||| || ||||.|
|      ||          ||    ..|
|.|| ||||||| || ||||||| || |
|.|| ||||||| || ||||||| || |
|.||. ..  .. || .     ..|| |
|.||||||| |||||||| ||||||| |
| ||||||| |||||||| ||||||| |
|      ... .     .    .  . |
|.||.||||.|||||||| ||||.||.|
| || |||| ||||||||.||||.||.|
| ||  .|| ||.!  ||.||  .||.|
| |||| || || || || || |||| |
