||||||||||||||||||||||||||||
|.  . .   ||!.. ||    .    |
| |||| || || ||.|| || ||||.|
|o|||| || || ||.|| ||.||||o|
| .    || ||.|| || ||      |
|||.|||||.. .||... |||||.|||
||| ||||| ||||||||.|||||.|||
    .  || |||||||| ||.      
||| || ||  ..    . || || |||
|||.||.|| |||||||| ||.|| |||
|||.|| || |||||||| || || |||
| . ||                ||  .|
|.||||.|| |||--||| ||.|||| |
| |||| || |      | || |||| |
|   . .|| |   ?  | ||. . ..|
||| ||||| |      | ||||| |||
||| ||||| |||||||| ||||| |||
|||                      |||
|||.|||||||| || |||||||| |||
||| |||||||| || |||||||| |||
    ||  ..   || ..   .||    
||| || || |||||||| || || |||
||| || || ||||||||.|| || |||
|||    ||        . ||    |||
|||.|| ||||| || ||||| || |||
||| || ||||| || |||||.||.|||
|  .|| || .  ||    || ||   |
| |||| || |||||||| ||.||||.|
