|    ... .    . .. .   .   |
| ||||||| ||||||||.||||||| |
|o|||||||.||||||||.|||||||o|
| . || . .   ||. .?.  ||   |
|||.|| || || || || ||.|| |||
||| || || ||.|| || ||.||.|||
||| ||.|| ||.|| || ||.|| |||
|||  . || || .  || ||  . |||
||| ||||| |||||||| ||||| |||
|||.||||| |||||||| ||||| |||
    .  ||          ||  ..   
|||.||.|| |||--||| ||.|| |||
||| || || |      | || ||.|||
|   ||    |      |    ||   |
| |||| || |      | || |||| |
| |||| || |||||||| || |||| |
|    . ||         !||.     |
|.|| ||||||| || |||||||.|| |
|.|| ||||||| || |||||||.|| |
| ||  .      || .       || |
| |||||||.|||||||| ||||||| |
| |||||||.|||||||| |||||||.|
|  .   .    .   .        . |
| || |||| |||||||| |||| || |
| || |||| |||||||| ||||.|| |
| ||.. || ||   .||.||.  || |
| |||| || ||.||.|| || |||| |
