||||||||||||||||||||||||||||
|        ..   .  .    .    |
| ||||.|| |||||||| || ||||.|
| |||| || |||||||| ||.|||| |
|o||||.||   .||... || ||||o|
|    . ||.|| || ||.|| .    |
| ||.|||| || || || ||||.|| |
|.|| |||| || || ||.|||| || |
| ||      || .  ||      ||.|
| |||| || |||||||| || ||||.|
|.|||| || |||||||| || |||| |
|!.    ||          ||     .|
|||| |||| |||--||| |||| ||||
|||| |||| |      | |||| ||||
||||      |   ?  |      ||||
|||| |||| |      | |||| ||||
||||.|||| |||||||| |||| ||||
|||| ||              ||.||||
|||| || |||| || ||||.||.||||
|||| || |||| || |||| || ||||
        ||   ||   ||  ..    
|||| || || ||||||.||.|| ||||
|||| || ||.|||||| ||.|| ||||
|.   ||   ..    .    ||    |
| || |||||||.|| ||||||| || |
| || ||||||| ||.||||||| ||.|
|o||         ||. . .    ||.|
|.||||.|| ||||||||.|| |||| |
