|      . .    .  .   .     |
| ||||.|| |||||||| || |||| |
| |||| || |||||||| ||.||||.|
|o||||.||    ||    || ||||o|
|      || || || ||.||.  .  |
| || |||| ||.||.|| |||| || |
| || |||| || ||.|| ||||.|| |
| ||.  . .||    ||. .   ||.|
| |||| || |||||||| || |||| |
| |||| || |||||||| || |||| |
|!.. . ||          || .  . |
|||| |||| |||--||| |||| ||||
|||| |||| |      | |||| ||||
||||      |   ?  |      ||||
||||.|||| |      | |||| ||||
|||| |||| |||||||| ||||.||||
|||| ||              || ||||
||||.|| |||| || |||| || ||||
|||| || |||| || |||| ||.||||
    . . ||  .|| . ||.  .    
|||| || || |||||| || || ||||
|||| || || |||||| || || ||||
|..  ||. . .         ||  . |
| || ||||||| || ||||||| || |
| || ||||||| || ||||||| ||.|
|o||   ..   .||  . .  . || |
| ||||.|| |||||||| || |||| |
