|      .    .  . .       . |
|.|||| || |||||||| || |||| |
|.|||| || |||||||| ||.|||| |
|o||||.||    ||   .|| ||||o|
|.     || || || || || . .. |
|.|| |||| || || ||.||||.|| |
| || |||| || || || ||||.||.|
| ||.. .  ||.   ||      || |
|.||||.|| |||||||| ||.||||.|
| ||||.|| |||||||| || |||| |
|!  .  ||          ||     ?|
|||| |||| |||--||| |||| ||||
|||| |||| |      | ||||.||||
||||      |      |      ||||
|||| |||| |      | ||||.||||
||||.|||| |||||||| ||||.||||
|||| ||.            .||.||||
||||.|| |||| || ||||.|| ||||
|||| ||.|||| || ||||.|| ||||
       .||.. ||. .||.       
|||| || || |||||| || || ||||
|||| || || ||||||.|| || ||||
|   .||   .         .||    |
| ||.||||||| || ||||||| || |
| || |||||||.|| ||||||| ||.|
|o||    . .  ||   ...   || |
| |||| || |||||||| || ||||.|
