|     ...       . ..       |
| ||||.||.|||||||| || |||| |
|.|||| ||.|||||||| || |||| |
|o||||.|| .  || .  || ||||o|
| .   .|| || || || ||    ..|
| || |||| || || || |||| || |
| ||.|||| || || || |||| || |
|.|| . .. ||  . ||.   . || |
| |||| || |||||||| || |||| |
|.|||| || |||||||| ||.|||| |
|!     ||          ||.    .|
||||.|||| |||--||| |||| ||||
|||| |||| |      | |||| ||||
||||      |      |      ||||
|||| |||| |      | ||||.||||
|||| |||| |||||||| |||| ||||
|||| ||              || ||||
|||| || |||| || ||||.|| ||||
|||| ||.|||| || |||| ||.||||
    . . ||   ||   ||.      ?
|||| || ||.|||||| || || ||||
|||| || ||.|||||| || || ||||
|    ||     .      . ||   .|
|.||.|||||||.|| ||||||| ||.|
| || ||||||| || ||||||| || |
|o||  ..   . || .       || |
| |||| || ||||||||.|| |||| |
