||||||||||||||||||||||||||||
|   .  .  .   ....  ..  .  |
| ||||||| |||||||| ||||||| |
|o||||||| |||||||| |||||||o|
|  .||.      ||       ||  .|
|||.|| || || || || ||.|| |||
|||.|| || ||.|| || ||.|| |||
||| || || ||.||.|| || || |||
||| .  || || .. || ||.. .|||
||| ||||| |||||||| |||||.|||
|||.||||| |||||||| ||||| |||
     . ||          ||       
||| || || |||--||| ||.||.|||
||| || || |      | ||.||.|||
|  .||    |   ?  |    ||   |
| |||| || |      | || |||| |
| |||| || |||||||| || |||| |
|  .   ||          ||.   ..|
|.|| ||||||| || ||||||| || |
| || ||||||| || ||||||| || |
|.||.  . .   ||         ||.|
| |||||||.||||||||.||||||| |
| ||||||| |||||||| |||||||.|
| .         .     .  .  .  |
| || |||| ||||||||.|||| || |
| ||.|||| |||||||| |||| || |
| ||.  || || !  || ||.  ||.|
| |||| || || || || || ||||.|
