|    .. ..||..  || ..      |
| ||||||| || || || |||||||.|
|o||||||| ||.|| ||.|||||||o|
|   ||  ..   || . .  .||   |
||| || || |||||||| || || |||
||| || || |||||||| || || |||
||| || ||        . || || |||
|||    || |||||||| ||   .|||
|||.||||| |||||||| |||||.|||
|||.||||| |||||||| ||||| |||
| .                     .  |
|.||||||| |||--||| ||||||| |
| ||||||| |      | ||||||| |
| ..||    |   ?  |    ||  .|
|||.|| || |      | ||.|| |||
||| || || |||||||| || || |||
       ||          ||.      
||| |||||||| || |||||||| |||
||| |||||||| || ||||||||.|||
| .  . ||.   ||   .||   .. |
|.||||.||!|||||||| || |||| |
| |||| || |||||||| || |||| |
|.  .       .   .   ..  .  |
| ||||||| |||||||| ||||||| |
| |||||||.||||||||.||||||| |
|.||     .   ||.        || |
| || |||| || || ||.|||| ||o|
