||||||||||||||||||||||||||||
|      .  ||.   || .    .. |
| |||||||.|| || || ||||||| |
|o||||||| || || || |||||||o|
|. .||   . ..||   .. .|| . |
|||.|| || ||||||||.|| ||.|||
|||.||.||.|||||||| ||.|| |||
||| || ||...      .||.|| |||
|||    || |||||||| ||. . |||
||| ||||| |||||||| ||||| |||
||| ||||| |||||||| ||||| |||
|                          |
| ||||||| |||--||| ||||||| |
| ||||||| |      | ||||||| |
| . ||    |   ?  |    ||  .|
||| || || |      | ||.|| |||
||| || || |||||||| || || |||
    .  ||          ||       
|||.|||||||| || |||||||| |||
||| |||||||| || |||||||| |||
| ..   ||  ..||    ||  . . |
| |||| ||!|||||||| || ||||.|
| |||| || |||||||| || |||| |
|              .   .      .|
|.|||||||.||||||||.|||||||.|
|.||||||| |||||||| |||||||.|
| || ..    . || .    .. || |
| || |||| || || || |||| ||o|
