||||||||||||||||||||||||||||
| .   .   ||  . ||   . .   |
| ||||||| || || || ||||||| |
|o||||||| || || || |||||||o|
|   ||    . .||.  .  .||.  |
||| ||.|| |||||||| || || |||
||| || ||.|||||||| ||.||.|||
||| || ||.       . || || |||
||| .. || |||||||| || .  |||
||| ||||| |||||||| ||||| |||
||| ||||| |||||||| |||||.|||
|                          |
|.||||||| |||--||| ||||||| |
| ||||||| |      | |||||||.|
|   ||    |   ?  |   .||   |
||| || || |      | || ||.|||
|||.|| || |||||||| || ||.|||
      .||          ||.      
||| |||||||| || |||||||| |||
||| |||||||| || |||||||| |||
|.     || . .||. . ||. .   |
|.||||.||!|||||||| || |||| |
| |||| || |||||||| || |||| |
|       .      .           |
| ||||||| ||||||||.||||||| |
| ||||||| |||||||| |||||||.|
| ||. .      || . .     || |
| || |||| || || || |||| ||o|
