|.  .  .  ||.   ||..   . . |
| ||||||| || || || ||||||| |
|o|||||||.||.|| || |||||||o|
| . ||.      || .     ||   |
||| || || |||||||| || || |||
||| || || ||||||||.|| || |||
||| || ||  .  ?    || || |||
|||   .|| |||||||| ||    |||
||| ||||| |||||||| ||||| |||
||| ||||| |||||||| ||||| |||
|                       .. |
| ||||||| |||--||| |||||||.|
|.||||||| |      | ||||||| |
|   ||    |      |    ||.  |
||| || || |      | || ||.|||
||| || || |||||||| || || |||
   .   ||          ||  ..   
||| |||||||| || |||||||| |||
||| |||||||| || |||||||| |||
|     .||    ||    ||  .   |
|.||||.||!|||||||| ||.|||| |
| |||| || |||||||| ||.|||| |
| .  .   .        ...      |
|.||||||| |||||||| ||||||| |
|.||||||| ||||||||.||||||| |
| ||   .     ||.  .    .|| |
| || |||| || || || ||||.||o|
