||||||||||||||||||||||||||||
| .. .!..    .    ..      .|
| ||||.|| |||||||| || |||| |
|o|||| || |||||||| || ||||o|
|   || ||    ||    || || . |
||| || || || || || || ||.|||
||| || || || || || || || |||
||| || || ||.|| || || ||.|||
          ||    ||.   .  .. 
|.||||||| |||||||| ||||||| |
| ||||||| |||||||| ||||||| |
|.||                    || |
| || |||| |||--||| ||||.||.|
| || |||| |      | |||| || |
|    .    |  ?   |   .  .  |
| |||| || |      | || ||||.|
| ||||.|| |||||||| || |||| |
| ||   ||          ||.. ||.|
| || ||||||| || ||||||| || |
|.|| ||||||| || ||||||| || |
  ... .||    ||.   ||       
| ||||.|| |||||||| || ||||.|
| ||||.|| |||||||| || |||| |
|      .  . .          .   |
|.|| |||| |||||||| |||| || |
|o|| |||| ||||||||.|||| ||.|
| ||.    ..  ||..   .  .|| |
|o||||| |||| || |||| ||||| |
