||||||||||||||||||||||||||||
| . .                 .. . |
| |||| || |||||||| || ||||.|
| |||| || |||||||| ||.|||| |
|o|||| ||    ||  ..|| ||||o|
|.  .  || || ||.|| || .  . |
| ||.|||| || || || |||| || |
|.|| ||||.|| || ||.||||.|| |
| ||   .  || ...||      || |
| |||| || |||||||| || |||| |
| |||| || |||||||| ||.||||.|
|!    .||          ||   . .|
||||.|||| |||--||| ||||.||||
|||| |||| |      | |||| ||||
||||.     |   ?  |      ||||
|||| |||| |      | |||| ||||
||||.|||| |||||||| |||| ||||
|||| ||.             || ||||
|||| || |||| || |||| || ||||
|||| || |||| || ||||.|| ||||
    ... ||   || . ||   .    
||||.|| || |||||| ||.||.||||
|||| ||.|| ||||||.|| || ||||
|    ||.        .    ||... |
| || ||||||| || ||||||| || |
| ||.|||||||.|| ||||||| ||.|
|o|| ..    . || .  .. . ||.|
|.|||| || |||||||| || |||| |
