|.  . . . ||! . ||  .   . .|
| ||||.||.||.|| || || |||| |
|o|||| || || || ||.|| ||||o|
| .    || || ||.|| ||  .  .|
||| |||||    || .  ||||| |||
||| ||||| |||||||| ||||| |||
     . || |||||||| ||.  .   
||| || ||    . .   || || |||
||| || || |||||||| || || |||
||| || || |||||||| || || |||
|.. ||                || ..|
|.|||| || |||--||| || ||||.|
|.||||.|| |      | || |||| |
|.    .|| |   ?  | ||    . |
||| ||||| |      | ||||| |||
||| ||||| |||||||| ||||| |||
|||                      |||
||| |||||||| || |||||||| |||
|||.|||||||| || |||||||| |||
    ||    . .||   . . ||    
|||.|| || ||||||||.|| || |||
||| ||.|| |||||||| || ||.|||
|||    ||   .  .  .||. . |||
|||.||.||||| || ||||| || |||
||| || |||||.|| ||||| ||.|||
| . ||.||.  .||    ||.||.  |
| ||||.|| |||||||| ||.||||.|
