| .       ||! ..||       ..|
| |||| || ||.|| || || |||| |
|o|||| ||.|| || || || ||||o|
|.  .  || || || || ||.     |
||| ||||| .  ||    ||||| |||
||| ||||| |||||||| |||||.|||
     . ||.|||||||| || .     
||| || ||     .    || || |||
||| || || |||||||| || ||.|||
||| ||.|| |||||||| ||.|| |||
| . ||                ||   |
| |||| || |||--||| ||.|||| |
| |||| || |      | || ||||.|
|      || |   ?  | || .   .|
||| ||||| |      | ||||| |||
||| ||||| |||||||| ||||| |||
|||                      |||
|||.|||||||| || |||||||| |||
|||.|||||||| || |||||||| |||
    || . .   ||       ||.   
|||.|| || |||||||| ||.||.|||
||| || || ||||||||.||.|| |||
|||  . ||        . ||    |||
||| || ||||| || ||||| ||.|||
|||.||.||||| || ||||| || |||
| . || ||    ||.   ||.|| . |
|.|||| || ||||||||.||.|||| |
