|   . ..  ||!   ||  .      |
|.||||.||.|| || ||.|| |||| |
|o|||| || || || || || ||||o|
|. ... || || || || ||  .   |
||| |||||  . ||    ||||| |||
||| |||||.|||||||| |||||.|||
     . ||.|||||||| || .     
||| || ||     ...  || ||.|||
||| || || |||||||| || || |||
||| ||.|| |||||||| || || |||
|   ||                ||  .|
| |||| || |||--||| || |||| |
| |||| || |      | || |||| |
|  .   || |      | ||      |
||| ||||| |      | ||||| |||
||| ||||| |||||||| ||||| |||
|||                      |||
||| |||||||| || ||||||||.|||
|||.|||||||| || |||||||| |||
    ||  .    ||  . .  ||.   
||| ||.||?|||||||| || ||.|||
|||.||.|| |||||||| ||.|| |||
|||    ||. .    .  || .  |||
|||.|| ||||| || ||||| || |||
||| ||.|||||.|| ||||| ||.|||
|.  || ||    ||    ||.||  .|
| ||||.|| |||||||| || ||||.|
