|   .  . .||!   ||      .. |
| ||||.||.|| || || || ||||.|
|o|||| || || || || || ||||o|
|. .  .|| ||.|| || ||  .   |
|||.|||||. . ||    ||||| |||
|||.||||| ||||||||.||||| |||
       || ||||||||.||  ..   
||| || ||.   ..  . ||.|| |||
|||.|| || |||||||| || || |||
||| || || |||||||| || || |||
|  .||                || ..|
|.|||| || |||--||| || |||| |
| |||| || |      | || |||| |
|.. .  || |   ?  | || .    |
||| ||||| |      | |||||.|||
||| ||||| |||||||| ||||| |||
|||                     .|||
||| |||||||| || |||||||| |||
|||.|||||||| || ||||||||.|||
    ||    .  ||   ....||    
||| || || |||||||| || ||.|||
||| || ||.|||||||| || ||.|||
|||    ||         .|| . .|||
||| || ||||| || ||||| || |||
||| || ||||| || ||||| || |||
|  .|| ||  ..||    || ||.. |
| |||| || ||||||||.|| |||| |
