|.....!....................|
|.||||.||.||||||||.||.||||.|
|o||||.||.||||||||.||.||||o|
|...||.||....||....||.||...|
|||.||.||.||.||.||.||.||.|||
|||.||.||.||.||.||.||.||.|||
|||.||.||.||.||.||.||.||.|||
 .........||....||......... 
|.||||||| |||||||| |||||||.|
|.||||||| |||||||| |||||||.|
|.||.                  .||.|
|.||.|||| |||--||| ||||.||.|
|.||.|||| |      | ||||.||.|
|......   |  ?   |   ......|
|.||||.|| |      | ||.||||.|
|.||||.|| |||||||| ||.||||.|
|.||...||          ||...||.|
|.||.||||||| || |||||||.||.|
|.||.||||||| || |||||||.||.|
 ......||....||....||...... 
|.||||.||.||||||||.||.||||.|
|.||||.||.||||||||.||.||||.|
|............  ............|
|.||.||||.||||||||.||||.||.|
|o||.||||.||||||||.||||.||.|
|.||.........||.........||.|
|o|||||.||||.||.||||.|||||.|
