|.....!....................|
|.||||.||.||||||||.||.||||.|
|o||||.||.||||||||.||.||||o|
|...||.||....||....||.||...|
|||.||.||.||.||.||.||.||.|||
|||.||.||.||.||.||.||.||.|||
|||.||.||.||.||.||.||.||.|||
 .........||.!..||......... 
|.||||||| |||||||| |||||||.|
|.||||||| |||||||| |||||||.|
|.||.                  .||.|
|.||.|||| |||--||| ||||.||.|
|.||.|||| |      | ||||.||.|
|......   |      |   ......|
|.||||.|| |      | ||.||||.|
|.||||.|| |||||||| ||.||||.|
|.||...||    ?     ||...||.|
|.||.||||||| || |||||||.||.|
|.||.||||||| || |||||||.||.|
 ......||....||....||...... 
|.||||.||.||||||||.||.||||.|
|.||||.||.||||||||.||.||||.|
|............  ............|
|.||.||||.||||||||.||||.||.|
|o||.||||.||||||||.||||.||.|
|.||.........||.........||.|
|o|||||.||||.||.||||.|||||.|
