|..........................|
|.|||||||.||||||||.|||||||.|
|o|||||||.||||||||.|||||||o|
|...||.......||...?...||...|
|||.||.|| ||.||.|| ||.||.|||
|||.||.|| ||.||.|| ||.||.|||
|||.||.|| ||.||.|| ||.||.|||
|||....|| ||....|| ||....|||
|||.||||| |||||||| |||||.|||
|||.||||| |||||||| |||||.|||
   ....||          ||....   
|||.||.|| |||--||| ||.||.|||
|||.||.|| |      | ||.||.|||
|...||.   |      |   .||...|
|.||||.|| |      | ||.||||.|
|.||||.|| |||||||| ||.||||.|
|......||         !||......|
|.||.||||||| || |||||||.||.|
|.||.||||||| || |||||||.||.|
|.||.........||.........||.|
|.|||||||.||||||||.|||||||.|
|.|||||||.||||||||.|||||||.|
|............  ............|
|.||.||||.||||||||.||||.||.|
|.||.||||.||||||||.||||.||.|
|.||...||.||. ..||.||...||.|
|.||||.||.||.||.||.||.||||.|
