|..........................|
|.|||||||.||||||||.|||||||.|
|o|||||||.||||||||.|||||||o|
|...||.......||.......||...|
|||.||.|| ||.||.|| ||.||.|||
|||.||.|| ||.||.|| ||.||.|||
|||.||?|| ||.||.|| ||.||.|||
|||....|| ||....|| ||....|||
|||.||||| |||||||| |||||.|||
|||.||||| |||||||| |||||.|||
   ....||          ||....   
|||.||.|| |||--||| ||.||.|||
|||.||.|| |      | ||.||.|||
|...||.   |      |   .||...|
|.||||.|| |      | ||.||||.|
|.||||.|| |||||||| ||.||||.|
|......||          ||......|
|.||.||||||| || |||||||.||.|
|.||.||||||| || |||||||.||.|
|.||.........||.........||.|
|.|||||||.||||||||.|||||||.|
|.|||||||.||||||||.|||||||.|
|............  ............|
|.||.||||.||||||||.||||.||.|
|.||.||||.||||||||.||||.||.|
|.||...||.||.!..||.||...||.|
|.||||.||.||.||.||.||.||||.|
