|..........................|
|.||||.||.||||||||.||.||||.|
|.||||.||.||||||||.||.||||.|
|o||||.||....||....||.||||o|
|......||.||.||.||.||......|
|.||.||||.||.||.||.||||.||.|
|.||.||||.||.||.||.||||.||.|
|.||......||....||......||.|
|.||||.|| |||||||| ||.||||.|
|.||||.|| |||||||| ||.||||.|
|!.....||          ||......|
||||.|||| |||--||| ||||.||||
||||.|||| |      | ||||.||||
||||.     |   ?  |     .||||
||||.|||| |      | ||||.||||
||||.|||| |||||||| ||||.||||
||||.||.            .||.||||
||||.||.|||| || ||||.||.||||
||||.||.|||| || ||||.||.||||
    ....||...||...||....    
||||.||.||.||||||.||.||.||||
||||.||.||.||||||.||.||.||||
|....||......  ......||....|
|.||.|||||||.||.|||||||.||.|
|.||.|||||||.||.|||||||.||.|
|o||.........||.........||.|
|.||||.||.||||||||.||.||||.|
