||||||||||||||||||||||||||||
|.........||....||.........|
|.|||||||.||.||.||.|||||||.|
|o|||||||.||.||.||.|||||||o|
|...||.......||.......||...|
|||.||.||.||||||||.||.||.|||
|||.||.||.||||||||.||.||.|||
|||.||.||..........||.||.|||
|||....|| |||||||| ||....|||
|||.||||| |||||||| |||||.|||
|||.||||| |||||||| |||||.|||
|...                    ...|
|.||||||| |||--||| |||||||.|
|.||||||| |      | |||||||.|
|...||.   |   ?  |   .||...|
|||.||.|| |      | ||.||.|||
|||.||.|| |||||||| ||.||.|||
   ....||          ||....   
|||.|||||||| || ||||||||.|||
|||.|||||||| || ||||||||.|||
|......||....||....||......|
|.||||.||!||||||||.||.||||.|
|.||||.||.||||||||.||.||||.|
|............  ............|
|.|||||||.||||||||.|||||||.|
|.|||||||.||||||||.|||||||.|
|.||.........||.........||.|
|.||.||||.||.||.||.||||.||o|
