|.........||!...||.........|
|.||||.||.||.||.||.||.||||.|
|o||||.||.||.||.||.||.||||o|
|......||.||.||.||.||......|
|||.|||||....||....|||||.|||
|||.|||||.||||||||.|||||.|||
   ....||.||||||||.||....   
|||.||.||..........||.||.|||
|||.||.|| |||||||| ||.||.|||
|||.||.|| |||||||| ||.||.|||
|...||.              .||...|
|.||||.|| |||--||| ||.||||.|
|.||||.|| |      | ||.||||.|
|......|| |      | ||......|
|||.||||| |      | |||||.|||
|||.||||| |||||||| |||||.|||
|||.                    .|||
|||.|||||||| || ||||||||.|||
|||.|||||||| || ||||||||.|||
   .||.......||.......||.   
|||.||.||?||||||||.||.||.|||
|||.||.||.||||||||.||.||.|||
|||....||....  ....||....|||
|||.||.|||||.||.|||||.||.|||
|||.||.|||||.||.|||||.||.|||
|...||.||....||....||.||...|
|.||||.||.||||||||.||.||||.|
